players 2
rows 8
cols 8
m 00000001
m 01111100
m 00001100
m 01101101
m 00110010
m 01110000
m 01001101
m 11100110