players 2
rows 8
cols 8
m 01101100
m 01010101
m 10111100
m 00001111
m 10101010
m 00000001
m 11100011
m 00101000