players 2
rows 8
cols 8
m 00010000
m 00010011
m 01011101
m 10110000
m 10110110
m 01011101
m 01010001
m 10010101