players 2
rows 8
cols 8
m 00001001
m 10111011
m 01110010
m 11010110
m 11011000
m 11101101
m 01011111
m 01011110