players 2
rows 8
cols 8
m 10101001
m 00010000
m 01101011
m 10100000
m 01011001
m 00001101
m 01100111
m 10000000